0 0 6 6
1 0 5 6
2 0 4 6

3 1 7 6 
4 1 6 5
5 1 5 4
6 1 4 5
7 1 3 6

8 2 8 5
9 2 7 4
10 2 6 4
11 2 5 5
12 2 4 4
13 2 3 4
14 2 2 5

15 3 9 6
16 3 8 4
17 3 7 3
18 3 6 3
19 3 5 2
20 3 4 3
21 3 3 3
22 3 2 4
23 3 1 6

24 4 10 6
25 4 9 5
26 4 8 4
27 4 7 3
28 4 6 2
29 4 5 1
30 4 4 2
31 4 3 3
32 4 2 4
33 4 1 5
34 4 0 6

35 5 10 6
36 5 9 4
37 5 8 5
38 5 7 2
39 5 6 1
40 5 5 0
41 5 4 1
42 5 3 2
43 5 2 5
44 5 1 4
45 5 0 6

46 6 10 6
47 6 9 5
48 6 9 4
49 6 7 3
50 6 6 2
51 6 5 1
52 6 4 2
53 6 3 3
54 6 2 4
55 6 1 5
56 6 0 6

57 7 9 6
58 7 8 4
59 7 7 3
60 7 6 3
61 7 5 2
62 7 4 3
63 7 3 3
64 7 2 4
65 7 1 6

66 8 8 5
67 8 7 4
68 8 6 4
69 8 5 5
70 8 4 4
71 8 3 4
72 8 2 5

73 9 7 6
74 9 6 5
75 9 5 4
76 9 4 5
77 9 3 6

78 10 6 6
79 10 5 6
80 10 4 6