number - x - y - priority - shiftX, shiftY
0 0 6 6 0 5
1 0 5 6 0 4
2 0 4 6 1 3

3 1 7 6 0 6
4 1 6 5 2 5
5 1 5 4 2 4
6 1 4 5 2 2
7 1 3 6 3 1

8 2 8 5 1 6
9 2 7 4 2 6
10 2 6 4 1 5
11 2 5 5 1 4
12 2 4 4 2 3
13 2 3 4 3 2
14 2 2 5 4 1

15 3 9 6 1 7
16 3 8 4 2 7
17 3 7 3 3 6
18 3 6 3 3 4
19 3 5 2 4 4
20 3 4 3 3 3
21 3 3 3 4 3
22 3 2 4 5 2
23 3 1 6 4 0

24 4 10 6 3 9 
25 4 9 5 2 8
26 4 8 4 3 8
27 4 7 3 3 7
28 4 6 2 3 5
29 4 5 1 5 4
30 4 4 2 5 3
31 4 3 3 6 3
32 4 2 4 5 1
33 4 1 5 5 2
34 4 0 6 5 0

35 5 10 6 4 10
36 5 9 4 4 8
37 5 8 5 4 9
38 5 7 2 4 6
39 5 6 1 4 5
40 5 5 0 5 5
41 5 4 1 6 5
42 5 3 2 6 4
43 5 2 5 6 1
44 5 1 4 6 2
45 5 0 6 6 0

46 6 10 6 5 10
47 6 9 5 5 8
48 6 8 4 5 9
49 6 7 3 4 7
50 6 6 2 5 7
51 6 5 1 5 6
52 6 4 2 7 5
53 6 3 3 7 3
54 6 2 4 7 2
55 6 1 5 8 2
56 6 0 6 7 1

57 7 9 6 6 10
58 7 8 4 6 8
59 7 7 3 6 7
60 7 6 3 7 7
61 7 5 2 6 6
62 7 4 3 7 6
63 7 3 3 7 4
64 7 2 4 8 3
65 7 1 6 9 3

66 8 8 5 6 9
67 8 7 4 7 8
68 8 6 4 8 7
69 8 5 5 9 6
70 8 4 4 9 5
71 8 3 4 8 4
72 8 2 5 9 4

73 9 7 6 7 9
74 9 6 5 8 8
75 9 5 4 8 6
76 9 4 5 8 5
77 9 3 6 10 4

78 10 6 6 9 7
79 10 5 6 10 6
80 10 4 6 10 5